type octile
height 16
width 26
map
@@@@@@@@@@@@@@@@@@@@@@@@@@
@....@@....@@.....@@@@@@@@
@....@@....@@.....@@@@@@@@
@....@@....@@.....@@@@@@@@
@....@@....@@.....@@@@@@@@
@@.@@@@@.@@@@@.@.@@@@@@@@@
@@.@@@@@.@@@@@.@.@@@@@@@@@
@........................@
@........................@
@@@.@@@@@@@@@@@@@@@@@@@@@@
@@@.@@@@@@@@@@@@@@@@@@@@@@
@@....@@@@@@@@@@@@@@@@@@@@
@@@@...@@@@@@@@@@@@@@@@@@@
@@@@...@@@@@@@@@@@@@@@@@@@
@@@@...@@@@@@@@@@@@@@@@@@@
@@@@@@@@@@@@@@@@@@@@@@@@@@
